||||||||||||||||||||
|------------------|
|-----!------------|
|------------------|
|--######----!-----|
|-----#######------|
|-------!---!------|
|------------------|
|-|--|-|||-|-|--|--|
|-||-|-|-|-|-|-|-|-|
|#|-||-|-|-|-|-|||#|
|#|--|-|||--|--|-|#|
|--!---------------|
|--------#-----!---|
|-----######-------|
|----########------|
|-----######-------|
|-$------#----!----|
|------------------|
||||||||||||||||||||
